{
	"textureName": "Aisen Field",
	"layer0Rects":
	[{
		"x": 3,
		"y": 23,
		"width": 470,
		"height": 276
	}],
	"layer0FrameTime": 1.0,
	"layersRect":
	[{
		"x": 477,
		"y": 23,
		"width": 470,
		"height": 276
	},
	{
		"x": 3,
		"y": 303,
		"width": 470,
		"height": 276
	},
	{
		"x": 477,
		"y": 303,
		"width": 470,
		"height": 276
	}],
	"backgroundColor":
	{
		"r": 56,
		"g": 72,
		"b": 80
	},
	"mapWidth": 16,
	"mapHeight": 13,
	"referencePosition":
	{
		"x": 211,
		"y": 42
	},
	"startTiles":
	[{
		"x": 2,
		"y": 11
	},
	{
		"x": 3,
		"y": 11
	},
	{
		"x": 4,
		"y": 11
	},
	{
		"x": 5,
		"y": 11
	},
	{
		"x": 2,
		"y": 12
	},
	{
		"x": 3,
		"y": 12
	},
	{
		"x": 4,
		"y": 12
	},
	{
		"x": 5,
		"y": 12
	}],
	"heightMap":
	[4, 4, 4, 4, 4, 3, 3, 4, 3, 3, 3, 5, 4, 4, 3, 3,
	 4, 4, 4, 4, 4, 3, 4, 3, 3, 3, 3, 4, 3, 3, 3, 3,
	 4, 4, 4, 3, 3, 3, 3, 3, 3, 4, 3, 3, 3, 3, 3, 1,
	 4, 4, 3, 2, 2, 3, 3, 3, 3, 3, 3, 3, 3, 2, 1, 1,
	 3, 3, 3, 2, 1, 1, 1, 2, 2, 1, 1, 2, 1, 1, 1, 1,
	 3, 3, 3, 1, 1, 1, 1, 1, 1, 1, 1, 1, 1, 1, 1, 1,
	 3, 1, 2, 1, 1, 1, 1, 1, 1, 1, 1, 1, 1, 1, 1, 1,
	 1, 1, 1, 1, 1, 1, 1, 1, 1, 1, 1, 1, 1, 1, 1, 1,
	 1, 1, 1, 1, 1, 1, 1, 1, 1, 1, 1, 1, 1, 1, 1, 1,
	 1, 1, 1, 1, 1, 1, 1, 1, 1, 1, 1, 1, 1, 1, 1, 1,
	 4, 3, 1, 1, 1, 1, 1, 1, 1, 1, 1, 1, 1, 1, 1, 2,
	 3, 2, 1, 1, 1, 1, 1, 1, 1, 1, 1, 1, 1, 1, 2, 1,
	 2, 2, 1, 1, 1, 1, 1, 1, 1, 1, 1, 1, 1, 2, 2, 1],
	"walkabilityMap":
	[0, 0, 0, 0, 0, 0, 0, 0, 0, 0, 0, 0, 0, 0, 0, 0,
	 0, 1, 0, 0, 0, 0, 0, 0, 0, 0, 0, 0, 0, 0, 0, 0,
	 0, 0, 0, 0, 0, 0, 0, 0, 0, 0, 0, 0, 0, 0, 0, 0,
	 0, 0, 0, 0, 0, 0, 0, 0, 0, 0, 0, 0, 0, 0, 0, 0,
	 0, 0, 0, 0, 0, 0, 0, 0, 0, 0, 0, 0, 0, 0, 0, 0,
	 0, 0, 0, 0, 0, 0, 0, 0, 0, 0, 0, 0, 0, 0, 0, 0,
	 0, 0, 0, 0, 0, 0, 0, 0, 0, 0, 0, 0, 0, 0, 0, 0,
	 0, 0, 0, 0, 0, 0, 0, 0, 0, 0, 0, 0, 0, 0, 0, 0,
	 0, 0, 0, 0, 0, 0, 0, 0, 0, 0, 0, 0, 0, 1, 0, 0,
	 0, 0, 0, 0, 0, 0, 0, 0, 0, 0, 0, 0, 0, 0, 0, 0,
	 0, 0, 0, 0, 0, 0, 0, 0, 0, 0, 0, 0, 0, 0, 0, 0,
	 0, 0, 0, 0, 0, 0, 0, 1, 0, 0, 0, 0, 0, 0, 0, 0,
	 0, 0, 0, 0, 0, 0, 0, 0, 0, 0, 0, 0, 0, 0, 0, 0],
	 "priorityMap":
	[0, 0, 0, 0, 0, 0, 0, 1, 0, 0, 0, 1, 0, 0, 0, 0,
	 0, 0, 1, 0, 0, 0, 1, 1, 1, 0, 0, 1, 1, 0, 0, 0,
	 0, 1, 1, 1, 0, 0, 1, 1, 1, 2, 2, 1, 1, 1, 0, 0,
	 0, 0, 1, 0, 1, 1, 0, 0, 1, 2, 2, 2, 1, 1, 1, 0,
	 0, 0, 0, 1, 0, 1, 0, 1, 0, 1, 0, 2, 2, 1, 1, 1,
	 0, 0, 0, 0, 1, 0, 1, 1, 1, 0, 1, 1, 2, 2, 1, 1,
	 0, 0, 1, 0, 0, 1, 0, 1, 1, 1, 0, 1, 1, 2, 2, 1,
	 0, 0, 1, 1, 0, 0, 1, 0, 1, 1, 1, 0, 1, 1, 2, 2,
	 0, 0, 0, 1, 1, 0, 0, 1, 0, 1, 1, 1, 0, 0, 2, 2,
	 0, 0, 0, 0, 1, 1, 0, 0, 1, 0, 1, 1, 1, 2, 2, 2,
	 1, 1, 1, 0, 0, 1, 1, 0, 0, 1, 0, 1, 1, 1, 2, 3,
	 0, 1, 1, 1, 0, 0, 1, 0, 2, 0, 1, 0, 1, 1, 3, 3,
	 0, 0, 1, 1, 1, 0, 0, 2, 2, 2, 0, 1, 0, 2, 3, 3]
}